NO ./textures/wall1.xpm

SO ./textures/wall2.xpm

WE ./textures/wall3.xpm

EA ./textures/wall4.xpm

F 220,100,000

C 225,30,0

   1111111111
  10N00001
   1111111111